reccodmission	recognition
unpair	unpaired
oconomic	economic
accidnts	accidents
succes	successful
enthousiastic	enthusiastic
produse	produce
tecnologycal	technological
upto	up to
poisioning	poisoning
competitiors	competitors
riks	risks
definations	definitions
vivd	vivid
tradind	trading
materail	material
useig	used
thoese	these
concludsion	conclusion
controll	control
thise	this
banefit	benefit
fatct	fact
condamnation	condemnation
forula	formula
thingh	thing
migth	might
healtheir	healthier
everythingfor	everything for
beleif	belief
resourses	resources
advantanges	advantages
diguise	disguise
additionly	additionally
opportunnity	opportunity
urself	yourself
rebelion	rebellion
chioce	choice
consdiered	considered
travals	travels
inturn	in turn
inly	only
everydays	every day
specilaized	specialized
runned	run
allive	alive
anylonger	any longer
explantion	explanation
insearch	in search
advertisments	advertisement
referencial	referential
processure	procedure
whis	wish
populization	popularization
prodcut	product
beleived	believed
backgrounging	backgrounding
difinetly	definitely
addtion	addition
anyhting	anything
variatons	variations
interfer	interfere
eloctronics	electronics
undestanded	understood
easially	easily
assestments	assessments
regared	regarded
knowlkedge	knowledge
successs	success
represant	represent
actractive	attractive
nood	no
focuss	focus
decreace	decrease
magagine	magazine
knowedge	knowledge
relativley	relatively
wheter	whether
convience	convince
extremly	extremely
espacilly	especially
becasuse	because
carrir	career
actualy	actually
calaberating	calibrating
simpley	simply
remanticism	romanticism
pannel	panel
diferrent	different
reguire	require
sucject	subject
diostract	distract
tremeadous	tremendous
dirive	derive
tecnologies	technology
desappear	disappear
genarally	generally
profesor	professor
abandant	abundant
greatt	great
trueth	truth
ist	is
independance	independence
plently	plenty
bycicle	bicycle
atempts	attempts
shuld	should
veichles	vehicles
thay	they
manufacturs	manufacturers
pippets	puppets
poder	powder
thougt	thought
withouth	without
maintanance	maintenance
sseen	seen
fonctions	functions
severel	several
reat	real
dosn't	doesn't
cheeper	cheaper
applaude	applaud
backgroung	background
counsiously	consciously
extreemly	extremely
exagerrate	exaggerate
citezens	citizens
pratices	practices
ues	use
instutions	institutions
qoute	quote
safty	safety
apealing	appealing
treaky	tricky
gourp	group
sstreet	street
releated	related
technologicall	technological
explaning	explaining
beacuse	because
becaomes	becomes
sunject	subject
soceity	society
empolyees	employees
dicision	decision
triump	trump
intersesting	interesting
everytime	every time
consequenses	consequences
professer	professor
absulately	absolutely
groud	group
whitout	without
choses	chooses
implyed	implied
uderstand	understand
thta	that
tru	true
maior	major
comcerned	concerned
pthers	others
rollways	railways
futhermore	furthermore
pscyhology	psychology
bacause	because
confidense	confidence
invetion	invention
hasnt	hasn't
jop	job
demans	demons
hypocritic	hypocritical
comapnies	companies
everyhing	everything
dirve	drive
lossings	losses
tendancys	tendencies
strectly	strictly
explotion	explosion
regulary	regular
sbjects	subjects
socail	social
transporation	transportation
attemptt	attempt
venegance	vengeance
succesfsful	successful
chosed	chose
electresty	electricity
productor	producer
begined	begun
steadly	steadily
skillset	skill set
conjusted	congested
difficutlies	difficulties
tideous	tedious
categrized	categorize
summner	summer
tought	taught
colorfull	colorful
winnig	winning
doning	doing
infront	in front
espescially	especially
goverment	government
unbeatble	unbeatable
undesrtand	understand
peopele	people
biger	bigger
defferent	different
easally	easily
acheivement	achievement
ocassion	occasion
undestood	understood
diferent	different
necessery	necessary
corporates	corporations
useccessful	unsuccessful
pertinet	pertinent
stuedents	students
witheir	with their
particulaly	particularly
stoarge	storage
costums	customs
numbre	number
challeging	challenging
learnin	learning
unkown	unknown
knowdledge	knowledge
busisness	business
traviling	traveling
doupt	doubt
demend	demand
advantege	advantage
adventage	advantage
programes	programs
recource	resource
wopuld	would
appened	happened
speific	specific
afast	a fast
feeded	fed
fellowed	followed
aming	aiming
persisstance	persistence
studyied	studied
unfotunately	unfortunately
maimtainance	maintenance
capcatiy	capacity
acheive	achieve
insted	instead
inaddition	in addition
repetedly	repeatedly
chanse	chance
eficient	efficient
explaiin	explain
acient	ancient
knowlwdge	knowledge
fourthy	fourthly
fathremore	furthermore
probabaly	probably
explaned	explained
tipically	typically
esential	essential
todyay	today
medicin	medicine
knowloedge	knowledge
challange	challenge
imputs	inputs
erros	errors
gazoline	gasoline
resevered	reserved
valueable	valuable
monotenous	monotonous
thridly	thirdly
throught	through
ljust	just
adverisments	advertisements
cuantites	quantities
confedent	confident
catastrophies	catastrophes
dengulous	dangerous
gehing	behind
elses	else
governamnets	governments
benifits	benefits
perfomance	performance
constructivity	constructiveness
sience	science
expectory	expected
overcrowed	overcrowded
acdemic	academic
yuong	young
majoritey	majority
understnad	understand
togeather	together
impac	impact
insited	insisted
adverisments	advertisement
suppport	support
commnunities	communities
enjoyement	enjoyment
commerece	commerce
aroung	around
futball	football
completey	completely
ideolgies	ideologies
stiation	situation
divede	divide
recoganize	recognize
consumtion	consumption
resposibilities	responsibilities
attension	attention
avdertisements	advertisements
estructure	structure
positioins	positions
profe	proof
diffinetely	definitely
apprecaite	appreciate
eveyday	every day
benefitial	beneficial
thunds	thousands
explation	explanation
acedemics	academic
thinkin	thinking
improvment	improvement
tierd	tired
stronfly	strongly
becose	because
poupolation	population
sourves	sources
advirtisemnts	advertisements
cleannig	cleaning
ot	not
somone	someone
contrated	contracted
stratagie	strategy
offspings	offsprings
promotioned	promoted
lonelyness	loneliness
mathematicly	mathematically
tfacts	facts
envolves	involves
decison	decision
neccessary	necessary
speacialized	specialized
borring	boring
overwelming	overwhelming
undergraduation	undergraduate
toughtful	thoughtful
partiall	partially
disadvantanges	disadvantages
thousans	thousands
pf	of
tradicional	traditional
arounded	surrounded
suitation	situation
ratinoally	rationally
dailylife	daily life
classnotes	class notes
sevice	service
guaranted	guaranteed
speicific	specific
prefered	preferred
agrrement	agreement
partents	parents
niether	neither
answr	answer
costomer	customer
occaion	occasion
dillemma	dilemma
libarally	liberal
advertsements	advertisements
knoledge	knowledge
qeustion	question
selles	sellers
secondally	secondly
phisical	physical
rigth	right
tommorrow	tomorrow
eveybody	everybody
prestently	presently
conept	concept
condictions	conditions
binded	bound
parcipate	participate
faomous	famous
forgeting	forgetting
sepcialize	specialize
keept	kept
sceince	science
cleakish	cliquish
currect	correct
diferents	different
universitites	universities
strenth	strength
confiently	confidently
initiaters	initiators
gemany	germany
foucs	focus
repeatly	repeatedly
shold	should
toursit	tourist
thourough	thorough
travler	traveler
commun	communal
adaptibility	adaptability
reall	really
souces	sources
necessasy	necessary
begening	beginning
oppions	opinions
understan	understand
picted	depicted
tirdly	tightly
abondan	abandon
entusiastic	enthusiastic
availible	available
secondley	secondly
telents	talents
tremedous	tremendous
carkeepers	car keepers
conceptsthey	concepts they
neigbours	neighbours
frustartion	frustration
stoping	stopping
comperhend	comprehend
hightly	highly
pilars	pillars
specializaton	specialization
habbit	habit
overboarded	overcrowded
dosis	dosage
althogh	although
cannnot	cannot
siutation	situation
complish	accomplish
infomation	information
alternativ	alternatives
aknowledge	acknowledge
adittion	addition
efficent	efficient
anlize	analyze
migh	might
becuase	because
bieng	being
volunterre	volunteer
accopmlish	accomplish
isac	isaac
demostrated	demonstrated
restric	restrict
understad	understand
monedary	monetary
suplly	supply
sumup	sum up
vailable	available
treir	their
leding	leading
tipes	types
impotant	important
tring	trying
bussiness	business
appropiate	appropriate
seriose	seriously
enoght	enough
focuse	focus
disgree	disagree
perticular	particular
prelimenery	preliminary
adoid	avoid
unsaciable	insatiable
learnning	learning
comncepts	concepts
excitment	excitement
oin	one
somany	so many
parck	park
materialiastic	materialistic
connot	cannot
excercising	exercising
botonay	botany
becaue	because
canalizeing	channelling
somethimes	sometimes
ennvironment	environment
interrested	interested
beieve	believe
japon	japan
psunami	tsunami
capabilties	capabilities
pollutionfree	pollution free
governement	government
adviretesements	advertisement
imressive	impressive
teached	taught
yokimusa	yukimura
firts	first
raisuig	rising
attractiv	attractive
consuption	consumption
amont	amount
